{
"board":[
"0000000000010000000W00000000000000000000",
"0000000000001000000W00000000000000000000",
"0000000000000100000W00000000000000000000",
"0000000000000000000W00000000000000000000",
"0000000000000000000W00000000000000000000",
"0000000000000000000W00000000000000000000",
"0000000000000000000W00000000000000000000",
"0000000000000000000000000000000000000000",
"0000000000000000000000000000000000000000",
"0000000000000000000000000000000000000000",
"0000000000000000000W00000000000000000000",
"0000000000000000000W00000000000000000000",
"0000000000000000000W00000000000000000000",
"0000000000000000000W00000000000000000000",
"0000000000000000000W00000000000000000000",
"0000000000000000000W00000000000000000000"
],
"dir":[1,1]
}

